{
  "width": 100,
  "height": 40,
  "layers": [
    {
      "name": "Bottom",
      "data": [
        ",,,,,,,,,,,,,,,,,,,,,,,,,,,,,,,,,,,,,,,,,,,,,,,,,,,,,,,,,,,,,,,,,,,,,,,,,,,,,,,,,,,,,,,,,,,,,,,,,,,,,,,,,,,,,,,,,,,,,,,,,,,,,,,,,,,,,,,,,,,,,,,,,,,,,,,,,,,,,,,,,,,,,,,,,,,,,,,,,,,,,,,,,,,,,,,,,,,,,,,,",
        ",,,,,,,,,,,,,,,,,,,,,,,,,,,,,,,,,,,,,,,,,,,,,,,,,,,,,,,,,,,,,♣,,,,,,,,,,,,,,,,,,,,,,,,,,,,,,,,,,,,,,,,,,,,,,,,,,,,,,,,,,,,,,,,,,,,,,,,,,,,,,,,,,,,,,,,,,,,,,,,,,,,,,,,,,,,,,,,,,,,,,,,,,,,,,,,,,,,,,,,,,",
        ",,,,,,,,,,,,,,,,,,,,,,,,,,,,,,,,,,,,,,,,,,,,,,,,,,,,,,,,,,,,,,,,,,,,,,,,,,,,,,,,,,,,,,,,,,,,,,,,,,,,,,,,,,,,,,,,,,,,,,,,,,,,,,,,,,,,,,,,,,,,,,,,,,,,,,,,,,,,,,,,,,,,,,,,,,,,,,,,,,,,,,,,,,,,,,,,,,,,,,,,",
        ",,,,,,,,,,,,,,,,,,,,,,,,,,,,,,,,,,,,,,,,,,,,,,,,,,,,,,,,,,,,,,,,,,,,,,,,,,,,,,,,,,,,,,,,,,,,,,,,,,,,,,,,,,,,,,,,,,,,,,,,,,,,,,,,,,,,,,,,,,,,,,,,,,,,,,,,,,,,,,,,,,,,,,,,,,,,,,,,,,,,,,,,,,,,,,,,,,,,,,,,",
        ",,,,,,,,,,,,,,,,,,,,,,,,,,,,,,,,,,,,,,,,,,,,,,,,,,,,,,,,,,,,,,,,,,,,,,,,,,,,,,,,,,,,,,,,,,,,,,,,,,,,,,,,,,,,,,,,,,,,,,,,,,,,,,,,,,,,,,,,,,,,,,,,,,,,,,,,,,,,,,,,,,,,,,,,,,,,,,,,,,,,,,,,,,,,,,,,,,,,,,,,",
        ",,,,,,,,,,,,,,,,,,,,,,,,,,,,,,,,,,,,,,,,,,,,,,,,,,,,,,,,,,,,,,,,,,,,,,,,,,,,,,,,,,,,,,,,,,,,,,,,,,,,,,,,,,,,,,,,,,,,,,,,,,,,,,,,,,,,,,,,,,,,,,,,,,,,,,,,,,,,,,,,,,,,,,,,,,,,,,,,,,,,,,,,,,,,,,,,,,,,,,,,",
        ",,,,,,,,,,,,,,,,,,,,,,,,,,,,,,,,,,,,,,,,,,,,,,,,,,,♣,,,,,,,,,,,,,,,,,,,,,,,,,,,,,,,,,,,,,,,,,,,,,,,,,,,,,,,,,,,,,,,,,,,,,,,,,,,,,,,,,,,,,,,,,,,,,,,,,,,,,,,,,,,,,,,,,,,,,,,,,,,,,,,,,,,,,,,,,,,,,,,,,,,,",
        ",,,,,,,,,,,,,,,,,,,,,,,,,,,,,,,,,,,,,,,,,,,,,,,,,,,,,,,,,,,,,,,,,,,,,,,,,,,,,,,,,,,♣,,,,,,,,,,,,,,,,,,,,,,,,,,,,,,,,,,,,,,,,,,,,,,,,,,,,,,,,,,,,,,,,,,,,,,,,,,,,,,,,,,,,,,,,,,,,,,,,,,,,,,,,,,,,,,,,,,,,",
        ",,,,,,,,,,,,,,,,,,,,,,,,,,,,,,,,,,,,,,,,,,,,,,,,,,,,,,,,,,,,,,,,,,,,,,,,,,,,,,,,,,,,,,,,,,,,,,,,,,,,,,,,,,,,,,,,,,,,,,,,,,,,,,,,,,,,,,,,,,,,,,,,,,,,,,,♣,,,,,,,,,,,,,,,,,,,,,,,,,,,,,,,,,,,,,,,,,,,,,,,,",
        ",,,,,,,,,,,,,,,,,,,,,,,,,,,,,,,,,,,,,,,,,,,,,,,,,,,,,,,,,,,,,,,,,,,,,,,,,,,,,,,,,,,,,,,,,,,,,,,,,,,,,,,,,,,,,,,,,,,,,,,,,,,,,,,,,,,,,,,,,,,,,,,,,,,,,,,,,,,,,,,,,,,,,,,,,,,,,,,,,,,,,,,,,,,,,,,,,,,,,,,,",
        ",,,,,,,,,,,,,,,,,,,,,,,,,,,,,,,,,,,,,,,,,,,,,,,,,,,,,,,,,,,,,,,,,,,,,,,,,,,,,,,,,,=<====%%%%%%%%%%%%%%=====>,,,,,,,,,,,,,,,,,♣,,,,,,,,,,,,,,,,,,,,,,,,,,,,,,,,,,,♣,,,,,,,,,,,,,,,,,,,,,,,,,,,,,,,,,,,,,,",
        ",,,,,,,,,,,,,,,,,,,,,,,,,,,,,,,,,,,,,,,,,,,,,,,,,,,,,,,,,,,,,,,,,,,,,♣,,,,,,,,,,,,=|PLPLPLCOCOCOCOPLPLPLPL=|,,,,,,,,,,,,,,,♣,,,,,♣,,,,,,,,,,,,,,,,,,,,,,,,,,,,,,,,,,,,,,,,,,,,,,,,,,,,,,,,,,,,,,,,,,,,,,",
        ",,,,,,,,,,,,,,,,,,,,,,,,,,,,,,,,,,,,,,,,,,,,,,,,,,,,,,,,,,,,,,,,,,,,,,,,,,,,,,,,,,%%PLPLPLCOCOCOCOPLPLPLPL=R====%%%%%%%%=======>,♣,♣,,,,,,,,,,,,,,,,,,,,,,,,,,,,,,,,,,,,,,,,,,,,,,,,,,,,,,,,,,,,,,,,,,,,",
        ",,,,,,,,,,,,,,,,,,,,,,,,,,,,,,,,,,,,,,,,,,,,,,,,,,,,,,,,,,,,,,,,,,,,,,,,,,,,,,,,,,%%PLPLPLCOCOCOCOPLPLPLPL=|PDPDPDPDPDPDPDPDPD=|,♣,,,,,,,,,,,,,,,,,,,♣,,,,,,,,,,,,,,,,,,,,,,,,,,,,,,,,,,,,,,,,,,,,,,,,,,",
        ",,,,,,,,,,,,,,,,,,,,,,,,,,,,,,,,,,,,,,,,,,,,,,,,,,,,,,,,,♣,,,,,,,,,,,,,,,,,,,,,,,,=|PLPLPLPLPLPLPLPLPLPLPLDDPDPDPDPDPDPDPDPDPD%%,,,,,,,,,,,,,,,,,,,,,,,,,,,,,,,,,,,,,,,,,,,,,,,,,,,,,,,,,,,,,,,,,,,,,,,,",
        ",,,,,,,,,,,,,,,,,,,,,,,,,,,,,,,,,,,,,,,,,,,,,,,,,,,,,,,♣,,,,,,,,,,,,,,,,,,,,,,,,,,%%PLPLPLPLPLPLPLPLPLPLPLDDPDPDPDPDPDPDPDPDPD%%,,,,,,,,,,,,,,,,,,,,,,,♣,,,,,,,,,,,,,,,,,,,,,,,,,,,,,,,,,,,,,,,,,,,,,,,,",
        ",,,,,,,,,,,,,,,,,,,,,,,,,,,,,,,,,,,,,,,,,,,,,,,,,,,,,,,,,,,,,,,,,,,,,,,,,,,,,,,,,,%%PLPLPLPLPLPLPLPLPLPLPLDDPDPDPDPDPDPDPDPDPD%%,,,,,,,,,,,,,,,,,,,,,,,,,,,,,,,,,,,,,,,,,,,,,,,,,,,,,,,,,,,,,,,,,,,,,,,,",
        ",,,,,,,,,,,,,,,,,,,,,,,,,,,,,,,,,,,,,,,,,,,,,,,,,,,,,♣,,,,,,,,,,,,,,,,,,,,,,,,,,,,=|PLPLPLPLPLPLPLPLPLPLPLDDPDPDPDPDPDPDPDPDPD=|,,,,,,,,,,,,,,,,,,,,,,,,,,,,,,,,,,,,,,,,,,,,,,,,,,,,,,,,,,,,,,,,,,,,,,,,",
        ",,,,,,,,,,,,,,,,,,,,,,,,,,,,,,,,,,,,,,,,,,,,,,,,,,,,,,,,,,,,,,,,,,,,,,,,===========TDDDDDDDDDDDD=D=========TDDDDDDDDDD========,,,,,,,,,,,,,,,,,,,,,,,,,,,,,,,♣,,,,,,,,,,,,,,,,,,,,,,,,,,,,,,,,,,,,,,,,,,",
        ",,,,,,,,,,,,,,,,,,,,,,,,,,,,,,,,,,,,,,,,,,,,,,,,,,,,,,,,,,,,TMTMTMTMTMTMTMTMTMTMTMTMTMTMTMTMTMTMDDTRTRTRTRTRTRTRTRTRTRTRTRTRTRTRTRTRTRTR,,,,,,,,,,,,,,,,,,,,,,,,,,,,,,,,,,,,,,,,,,,,,,,,,,,,,,,,,,,,,,,,",
        ",,,,,,,,,,,,,,,,,,,,,,,,,,,,,,,,,,,,,,,,,,,,,,,,,,,,,,,,,,,♣TMTMTMTMTMTMTMTMTMTMTMTMTMTMTMTMTMTMDDTRTRTRTRTRTRTRTRTRTRTRTRTRTRTRTRTRTRTR,,,,,,,,,,,,,,,,,,,,,,,,,,,,,,,,,,,,,,,,,,,,,,,,,,,,,,,,,,,,,,,,",
        ",,,,,,,,,,,,,,,,,,,,,,,,,,,,,,,,,,,,,,,,,,,,,,,,,,,,,,,,,,,,TMTMTMCRCRCRCRCRCRCRCRCRCRCRCRCRTMTMDDTRTRTRTRTRTRTRTRTRTRTRTRTRTRTRTRTRTRTR,,,,,,,,,,,,,,,,,,,,,,,,,,,,,,,,,,,,,,,,,,,,,,,,,,,,,,,,,,,,,,,,",
        ",,,,,,,,,,,,,,,,,,,,,,,,,,,,,,,,,,,,,,,,,,,,,,,,,,,,,,,,,,,,TMTMTMCRCRCRCRCRCRCRCRCRCRCRCRCRTMTMDDTRTRTRTRTRTRTRTRTRTRTRTRTRTRTRTRTRTRTR,,,,,,,,,,,,,,,,,,,,,,,,,,,,,,,,,,,,,,,,,,,,,,,,,,,,,,,,,,,,,,,,",
        ",,,,,,,,,,,,,,,,,,,,,,,,,,,,,,,,,,,,,,,,,,,,,,,,,,,,,,,,,,,,TMTMTMCRCRCRCRCRCRCRCRCRCRCRCRCRTMTMTYTYTYTYTYTYTYTYTYTYTYTYTYTYTYTYTYTYTYTYTY,,,,,,,,,,,,,,,♣,,,,,,,,,,,,,,,,,,,,,,,,,,,,,,,,,,,,,,,,,,,,,,",
        ",,,,,,,,,,,,,,,,,,,,,,,,,,,,,,,,,,,,,,,,,,,,,,,,,,,,,,,,,,,,TMTMTMTMTMTMTMTMTMTMTMTMTMTMTMTMTMTMTYTYTYTYTYTYTYTYTYTYTYTYTYTYTYTYTYTYTYTYTY,,,,,,,,,,,,,,,,,,,,,,,,,,,,,,,,,,,,,,,,,,,,,,,,,,,,,,,,,,,,,,",
        ",,,,,,,,,,,,,,,,,,,,,,,,,,,,,,,,,,,,,,,,,,,,,,,,,,,,,,,,,,,,TMTMTMTMTMTMTMTMTMTMTMTMTMTMTMTMTMTMTYTYTYTYTYTYTYTYTYTYTYTYTYTYTYTYTYTYTYTYTY,,,,,,,,,,,,,,,,,,,,,,,♣,,,,,,,,,,,,,,,,,,,,,,,,,,,,,,,,,,,,,,",
        ",,,,,,,,,,,,,,,,,,,,,,,,,,,,,,,,,,,,,,,,,,,,,,,,,,,,,,,,,,,,,,,,,,,,,,,,======%%%%%%%%%%%%%%====TYTYTYTYTYTYTYTYTYTYTYTYTYTYTYTYTYTYTYTYTY,,,,,,,,,,,,#W,,#W,,#W#W#W,,#W,,,,,,,,,,,,,,,,,,,,,,,,,,,,,,,,",
        ",,,,,,,,,,,,,,,,,,,,,,,,,,,,,,,,,,,,,,,,,,,,,,,,,,,,,,,,,,,,,,,,,,,,,,,,,,,,,,,,,,,,,,,,,,,,,,,,TYTYTYTYTYTYTYTYTYTYTYTYTYTYTYTYTYTYTYTYTY,,,,,,,♣,,,,#W,,#W,,,,#W,,,,#W,,,,,,,,,,,,,,,,,,,,,,,,,,,,,,,,",
        ",,,,,,,,,,,,,,,,,,,,,,,,,,,,,,,,,,,,,,,,,,,,,,,,,,,,,,,,,,,,,,,,,,,,,,,,,,,,,,,,,,,,,,,,,,,,,,,,TYTYTYTYTYTYTYTYTYTYTYTYTYTYTYTYTYTYTYTYTY,,,,,,,♣,,,,#W#W#W,,,,#W,,,,,,,,,,,,,,,,,,,,,,,,,,,,,,,,,,,,,,",
        ",,,,,,,,,,,,,,,,,,,,,,,,,,,,,,,,,,,,,,,,,,,,,,,,,,,,,,,,,,,,,,,,,,,,,,,,,,,,,,,,,,,,,,,,,,,,,,,,TYTYTYTYTYTYTYTYTYTYTYTYTYTYTYTYTYTYTYTYTY,,,,,,,,,♣,♣#W,,#W,,#W#W#W,,#W,,,,,,,,,,,,,,,,,,,,,,,,,,,,,,,,",
        ",,,,,,,,,,,,,,,,,,,,,,,,,,,,,,,,,,,,,,,,,,,,,,,,,,,,,,,,,,,,,,,,,,,,,,,,,,,,,,,,,,,,,,,,,,,,,,,,TYTYTYTYTYTYTYTYTYTYTYTYTYTYTYTYTYTYTYTYTY,,,,,,,,,,,,,,,,,,,,,,,,,,,,,,,,,,,,,,,,,,,,,,,,,,,,,,,,,,,,,,",
        ",,,,,,,,,,,,,,,,,,,,,,,,,,,,,,,,,,,,,,,,,,,,,,,,,,,,,,,,,,,,,,,,,,,,,,,,,,,,,,,,,,,,,,,,,,,,,,,,,,,,,,,,,,,,,,,,,,,,,,,,,,,,,,,,,,,,,,,,,,,,,♣,,,,,,,,,,,,,,,,,,,,,,FY,,,,,,,,,,,,,,,,,,,,,,,,,,,,,,,,,,",
        ",,,,,,,,,,,,,,,,,,,,,,,,,,,,,,,,,,,,,,,,,,,,,,,,,,,,,,,,,,,,,,,,,,,,,,,,,,,,,,,,,,,,,,,,,,,,,,,,,,,,,,,,,,,,,,,,,,,,,,,,,,,,,,,,,,,,,,,,,,,,,,,,,,,,,,,,,,,,,,,,,,,,Bs,,,,,,,,,,,,,,,,,,,,,,,,,,,,,,,,,,",
        ",,,,,,,,,,,,,,,,,,,,,,,,,,,,,,,,,,,,,,,,,,,,,,,,,,,,,,,,,,,,,,,,,,,,,,,,,,,,,,,,,,,,,,,,,,,,,,,,,,,,,,,,,♣,,,,,,,,,,,,,,,,,,,,,,,,,,,,,,,,,,,,,,,,,♣,,,,,,,,,,,,,,,,,,,,,,,,,,,,,,,,,,,,,,,,,,,,,,,,,,,,",
        ",,,,,,,,,,,,,,,,,,,,,,,,,,,,,,,,,,,,,,,,,,,,,,,,,,,,,,,,,,,,,,,,,,,,,,,,,,,,,,,,,,,,,,,,,,,,,,,,,,,,,,,,,,,,,,,,,,,,,,,,,,,,,,,,,,,,,,,,,,,,,,,,,,,,,,,,,,,,FR,,,,,,,,,,,,,,,,,,,,,,,,,,,,,,,,,,,,,,,,,,",
        ",,,,,,,,,,,,,,,,,,,,,,,,,,,,,,,,,,,,,,,,,,,,,,,,,,,,,,,,,,,,,,,,,,,,,,,,,,,,,,,,,,,,,,,,,,,,,,,,,,,,,,,,,,,,,,,,,,,,,,,,,,,,,,,,,,,,,,,,,♣,♣,,,,,,,,,,,,,,,,Bs,,,,,,,,,,,,,,,,,,FB,,,,,,,,,,,,,,,,,,,,,,",
        ",,,,,,,,,,,,,,,,,,,,,,,,,,,,,,,,,,,,,,,,,,,,,,,,,,,,,,,,,,,,,,,,,,,,,,,,,,,,,,,,,,,,,,,,,,,,,,,,,,,,,,,,,,,,,,,,,♣,,,,,,,,,,,,,,,,,,,,,,,,,,,,,,,,,,,,,♣,,,,,♣,,,,,,,,,,,,,,,,,,Bs,,,,,,,,,,,,,,,,,,,,,,",
        ",,,,,,,,,,,,,,,,,,,,,,,,,,,,,,,,,,,,,,,,,,,,,,,,,,,,,,,,,,,,,,,,,,,,,,,,,,,,,,,,,,,,,,,,,,,,,,,,,,,,,,,,,,,,,,,,,,,,,,,,,,,,,,,,,,,,,,,,,,,,,,,,,,,,,,,,,,,,,,,,,,,,,,,,,,,,,,,,,,,♣,,,,,,,,,,,,,,,,,,,,",
        ",,,,,,,,,,,,,,,,,,,,,,,,,,,,,,,,,,,,,,,,,,,,,,,,,,,,,,,,,,,,,,,,,,,,,,,,,,,,,,,,,,,,,,,,,,,,,,,,,,,,,,,,,,,,,,,,,,,,,,,,,,,,,,,,,,,,,,,,,,,,,♣,♣,,,,,,,,,,,,,,,,,,,,,,,,,,,,,,,,,,,,,,,,,,,,,,,,,,,,,,,,",
        ",,,,,,,,,,,,,,,,,,,,,,,,,,,,,,,,,,,,,,,,,,,,,,,,,,,,,,,,,,,,,,,,,,,,,,,,,,,,,,,,,,,,,,,,,,,,,,,♣,,,,,,,,,,,,,,,,,,,,,,,,,,,,,,,,,,,,,,,,,,,,,,,,,,,,,,,,,,,,,,,,,,,,,,,,,,,,,,,,,,,,,,,,,,,,,,,,,,,,,,,,"
      ]
    },
    {
      "name": "Mid",
      "data": [
        "............................................................................................................~~~~~~~~~~~~~~~~~~~~........................................................................",
        "..................................................................................................~~~~~~~~~~~~~~~~~~~~~~~~~~~~~~~~~~~~~~~~~~~~..........................................................",
        "..............................................................................................~~~~~~~~~~~~~~~~~~~~~~~D~D~D~D~D~~~~~~~~~~~~~~~~~~~~~~....................................................",
        "....................................BBBBBBBSBBBBBB........................................~~~~~~~~~~~~~~~~~~~D~D~D~D~D~D~D~D~D~D~D~D~~~~~~~~~~~~~~~~~~~~................................................",
        "..........................................................................................~~~~~~~~~~~~~~~~~~~D~D~D~D~D~D~D~D~D~D~D~D~~~~~~~~~~~~~~~~~~~~................................................",
        "............................................................BBBBBBBBBB....................~~~~~~~~~~~~~~~~~~~~~~~~~~~D~D~D~D~D~~~~~~~~~~~~~~~~~~~~~~~~~~................................................",
        "..................................................................................................~~~~~~~~~~~~~~~~~~~~~~~~~~~~~~~~~~~~~~~~~~~~..........................................................",
        "..............BBBBBSBBBBBB..............................................................................................................................................................................",
        "..............................................................................................................................................................................WL........................",
        "........................................................................................................................................................................................................",
        "..................................................................................=<====%%%%%%%%%%%%%%=====>............................................................................................",
        "..............................BBBBBBBSBbBBBSBbBBBBBB..............................=|..................WDWD=|............................................................................................",
        "..................................................................................%%..................WDWD=R====%%%%%%%%=======>........................................................................",
        "..................................................................................%%..................WDWD=|..................=|..............................................BBBBBBBSBBBBBBBBBB........",
        "..................................................................................=|......................DD..................%%........................................................................",
        "..................................................................................%%......................DD..................%%........................................................................",
        "..................................................................................%%......................DD..................%%........................................................................",
        "..................................................................................=|......................DD..................=|........................................................................",
        "..........................................................=<====DDDDDDDD===========TDDDDDDDDDDDD=D=========TDDDDDDDDDDDD=======T=========>..............................................................",
        "..........................................................=|..............WLWLWLWL..............DD......................................=|..............................................................",
        "..........................................................%%....................................DD......................................=|..............................BBBBBSBBBBBSBBBB................",
        "BBBBBSBBBB................................................%%....................................DD......................................=|..............................................................",
        "..........................................................=|....................................DD......................................=|..............................................................",
        "..........................................................=|#g..................................=R======DDDDDDDDDDDDDDDD=================L..............................................................",
        "..........................................................=|#g..................................=|..........................WDWDWDWDWD..=|..............................................................",
        "..................................WD......................=|#g#g#g#g..WLWL......................=|WDWD..................................DD..............................................................",
        "BBBSBBBBBBBBBB............................................=(==%%%%%%%%%%======DDDDDDDDDDDDDD=====LWDWD..................................DD..............................................................",
        "................................................................................................=|WDWD..................................DD..........................................BBBBBBBBBBBB........",
        "................................................................................................=|WDWD..................................DD..............................................................",
        "................................................................................................=|......................................DD..............................................................",
        "................................................................................................=(==========DDDDDDDDDDDDDDDDDDDD=========)..............................................................",
        "..BBBBBSBBBBBB..........................................................................................................................................................................................",
        "........................................................................................................................................................................................................",
        "......................................................WD................................................................................................................................................",
        "........................................................................................................................................................................................................",
        "........................................................................................................................................................................................................",
        "..............................WD..............................................................................................WD........................................................................",
        "............................................................................WD..........................................................................................................................",
        "........................................................................................................................................................................................................",
        "..........BBBBBBBBBBBBBBBB.............................................................................................................................................................................."
      ]
    },
    {
      "name": "Top",
      "data": [
        "........................................................................................................................................................................................................",
        "..........................................BBBB..........................................................................................................................BBBBBBBBBBBBBBBB................",
        "......................................BBBBBBBBBB........................................................................................................................BBBBBBBBBBBBBBBB................",
        "............................................................................................................................................................................BBBBBBBBBBBB................",
        "..............................................................BBBBBB........................................................................................................BBWLBB......................",
        "................BB............................................................................................................................................................WL........................",
        "................BBBbBBBb......................................................................................................................................................WL........................",
        "..............................................................................................................................................................................WL........................",
        "........................................................................................................................................................................................................",
        "....................................BBBBBb..............................................................................................................................................................",
        "................................BBBBBbBBBBBBBB..........................................................................................................................................................",
        "....................................................................................................................................................................................BB..................",
        "..................................................................................................................................................................................BBBBBB..BBBBBB........",
        "........................................................................................................................................................................................................",
        "........................................................................................................................................................................................................",
        "........................................................................................................................................................................................................",
        "........................................................................................................................................................................................................",
        "..................................BBBBBB......................................................................................................................................BBBBBB....................",
        "......BB........................BBBBBBBBBB..................................................................................................................................BBBBBBBBBB..................",
        "..BBBBBB......................BBBBBBBaBBBB..................................................................................................................................BBBBBBBBBBBB................",
        "..BBBBBB......................BaBBBBBBBBBBBB............................................................................................................................................................",
        "................................BBBBBBBBBaBB............................................................................................................................................................",
        "..................................WD..BBBB..............................................................................................................................................................",
        "..................................WD....................................................................................................................................................................",
        "BBBBBB............................WD....................................................................................................................................................................",
        "BBBBBBBBBB..............................................................................................................................................................................................",
        "......................................................BB..............................................................................................................................BBBB..BB..........",
        "....................................................BBBBBB..............................................................................................................................................",
        "......................................................WD................................................................................................................................................",
        "....BBBBBB........................................BBBBBBBBBB............................................................BBBBBBBB........................................................................",
        "....BBBBBBBB..................BBBB..................BBWDBB..................BB..........................................BBBBBBBBBBBBBB..................................................................",
        "............................BBBBBBBBBB..........BBBBBBBBBBBBBB............BBWDBB........................................BBBBBBBBBBBBBB..................................................................",
        "..........................BBBBBBBBBaBB................WD................BBBBBBBBBB............................................WDBB......................................................................",
        "..........................BBBBBaBBBBBB......................................WD..............................................BBWDBB......................................................................",
        "..............................WD......................................BBBBBBBBBBBBBB..........................................WD........................................................................",
        "..............................WD............................................WD................................................WD........................................................................",
        "....................................................................BBBBBBBBBBBBBBBBBB..................................................................................................................",
        "........................................................................................................................................................................................................",
        "..............BBBBBBBBBB................................................................................................................................................................................",
        "........................................................................................................................................................................................................"
      ]
    }
  ]
}
