{
  "width": 100,
  "height": 40,
  "layers": [
    {
      "name": "Bottom",
      "data": [
        ",,,,,,,,,,,,,,,,,,,,,,,,,,,,,,,,,,,,,,,,,,,,,,,,,,,,,,,,,,,,,,,,,,,,,,,,,,,,,,,,,,,,,,,,,,,,,,,,,,,,,,,,,,,,,,,,,,,,,,,,,,,,,,,,,,,,,,,,,,,,,,,,,,,,,,,,,,,,,,,,,,,,,,,,,,,,,,,,,,,,,,,,,,,,,,,,,,,,,,,,",
        ",,,,,,,,,,,,,,,,,,,,,,,,,,,,,,,,,,,,,,,,,,,,,,,,,,,,,,,,,,,,,,,,,,,,,,,,,,,,,,,,,,,,,,,,,,,,,,,,,,,,,,,,,,,,,,,,,,,,,,,,,,,,,,,,,,,,,,,,,,,,,,,,,,,,,,,,,,,,,,,,,,,,,,,,,,,,,,,,,,,,,,,,,,,,,,,,,,,,,,,,",
        ",,,,,,,,,,,,,,,,,,,,,,,,,,,,,,,,,,,,,,,,,,,,,,,,,,,,,,,,,,,,,,,,,,,,,,,,,,,,,,,,,,,,,,,,,,,,,,,,,,,,,,,,,,,,,,,,,,,,,,,,,,,,,,,,,,,,,,,,,,,,,,,,,,,,,,,,,,,,,,,,,,,,,,,,,,,,,,,,,,,,,,,,,,,,,,,,,,,,,,,,",
        ",,,,,,,,,,,,,,,,,,,,,,,,,,,,,,,,,,,,,,,,,,,,,,,,,,,,,,,,,,,,,,,,,,,,,,,,,,,,,,,,,,,,,,,,,,,,,,,,,,,,,,,,,,,,,,,,,,,,,,,,,,,,,,,,,,,,,,,,,,,,,,,,,,,,,,,,,,,,,,,,,,,,,,,,,,,,,,,,,,,,,,,,,,,,,,,,,,,,,,,,",
        ",,,,,,,,,,,,,,,,,,,,,,,,,,,,,,,,,,,,,,,,,,,,,,,,,,,,,,,,,,,,,,,,,,,,,,,,,,,,,,,,,,,,,,,,,,,,,,,,,,,,,,,,,,,,,,,,,,,,,,,,,,,,,,,,,,,,,,,,,,,,,,,,,,,,,,,,,,,,,,,,,,,,,,,,,,,,,,,,,,,,,,,,,,,,,,,,,,,,,,,,",
        ",,,,,,,,,,,,,,,,,,,,,,,,,,,,,,,,,,,,,,,,,,,,,,,,,,,,,,,,,,,,,,,,,,,,,,,,,,,,,,,,,,,,,,,,,,,,,,,,,,,,,,,,,,,,,,,,,,,,,,,,,,,,,,,,,,,,,,,,,,,,,,,,,,,,,,,,,,,,,,,,,,,,,,,,,,,,,,,,,,,,,,,,,,,,,,,,,,,,,,,,",
        ",,,,,,,,,,,,,,,,,,,,,,,,,,,,,,,,,,,,,,,,,,,,,,,,,,,,,,,,,,,,,,,,,,,,,,,,,,,,,,,,,,,,,,,,,,,,,,,,,,,,,,,,,,,,,,,,,,,,,,,,,,,,,,,,,,,,,,,,,,,,,,,,,,,,,,,,,,,,,,,,,,,,,,,,,,,,,,,,,,,,,,,,,,,,,,,,,,,,,,,,",
        ",,,,,,,,,,,,,,,,,,,,,,,,,,,,,,,,,,,,,,,,,,,,,,,,,,,,,,,,,,,,,,,,,,,,,,,,,,,,,,,,,,,,,,,,,,,,,,,,,,,,,,,,,,,,,,,,,,,,,,,,,,,,,,,,,,,,,,,,,,,,,,,,,,,,,,,,,,,,,,,,,,,,,,,,,,,,,,,,,,,,,,,,,,,,,,,,,,,,,,,,",
        ",,,,,,,,,,,,,,,,,,,,,,,,,,,,,,,,,,,,,,,,,,,,,,,,,,,,,,,,,,,,,,,,,,,,,,,,,,,,,,,,,,,,,,,,,,,,,,,,,,,,,,,,,,,,,,,,,,,,,,,,,,,,,,,,,,,,,,,,,,,,,,,,,,,,,,,,,,,,,,,,,,,,,,,,,,,,,,,,,,,,,,,,,,,,,,,,,,,,,,,,",
        ",,,,,,,,,,,,,,,,,,,,,,,,,,,,,,,,,,,,,,,,,,,,,,,,,,,,,,,,,,,,,,,,,,,,,,,,,,,,,,,,,,,,,,,,,,,,,,,,,,,,,,,,,,,,,,,,,,,,,,,,,,,,,,,,,,,,,,,,,,,,,,,,,,,,,,,,,,,,,,,,,,,,,,,,,,,,,,,,,,,,,,,,,,,,,,,,,,,,,,,,",
        ",,,,,,,,,,,,,,,,,,,,,,,,,,,,,,,,,,,,,,,,,,,,,,,,,,,,,,,,,,,,,,,,,,,,,,,,,,,,,,,,,,=<====%%%%%%%%%%%%%%=====>,,,,,,,,,,,,,,,,,,,,,,,,,,,,,,,,,,,,,,,,,,,,,,,,,,,,,,,,,,,,,,,,,,,,,,,,,,,,,,,,,,,,,,,,,,,,",
        ",,,,,,,,,,,,,,,,,,,,,,,,,,,,,,,,,,,,,,,,,,,,,,,,,,,,,,,,,,,,,,,,,,,,,,,,,,,,,,,,,,=|PLPLPLCOCOCOCOPLPLPLPL=|,,,,,,,,,,,,,,,,,,,,,,,,,,,,,,,,,,,,,,,,,,,,,,,,,,,,,,,,,,,,,,,,,,,,,,,,,,,,,,,,,,,,,,,,,,,,",
        ",,,,,,,,,,,,,,,,,,,,,,,,,,,,,,,,,,,,,,,,,,,,,,,,,,,,,,,,,,,,,,,,,,,,,,,,,,,,,,,,,,%%PLPLPLCOCOCOCOPLPLPLPL=R====%%%%%%%%=======>,,,,,,,,,,,,,,,,,,,,,,,,,,,,,,,,,,,,,,,,,,,,,,,,,,,,,,,,,,,,,,,,,,,,,,,,",
        ",,,,,,,,,,,,,,,,,,,,,,,,,,,,,,,,,,,,,,,,,,,,,,,,,,,,,,,,,,,,,,,,,,,,,,,,,,,,,,,,,,%%PLPLPLCOCOCOCOPLPLPLPL=|PDPDPDPDPDPDPDPDPD=|,,,,,,,,,,,,,,,,,,,,,,,,,,,,,,,,,,,,,,,,,,,,,,,,,,,,,,,,,,,,,,,,,,,,,,,,",
        ",,,,,,,,,,,,,,,,,,,,,,,,,,,,,,,,,,,,,,,,,,,,,,,,,,,,,,,,,,,,,,,,,,,,,,,,,,,,,,,,,,=|PLPLPLPLPLPLPLPLPLPLPLDDPDPDPDPDPDPDPDPDPD%%,,,,,,,,,,,,,,,,,,,,,,,,,,,,,,,,,,,,,,,,,,,,,,,,,,,,,,,,,,,,,,,,,,,,,,,,",
        ",,,,,,,,,,,,,,,,,,,,,,,,,,,,,,,,,,,,,,,,,,,,,,,,,,,,,,,,,,,,,,,,,,,,,,,,,,,,,,,,,,%%PLPLPLPLPLPLPLPLPLPLPLDDPDPDPDPDPDPDPDPDPD%%,,,,,,,,,,,,,,,,,,,,,,,,,,,,,,,,,,,,,,,,,,,,,,,,,,,,,,,,,,,,,,,,,,,,,,,,",
        ",,,,,,,,,,,,,,,,,,,,,,,,,,,,,,,,,,,,,,,,,,,,,,,,,,,,,,,,,,,,,,,,,,,,,,,,,,,,,,,,,,%%PLPLPLPLPLPLPLPLPLPLPLDDPDPDPDPDPDPDPDPDPD%%,,,,,,,,,,,,,,,,,,,,,,,,,,,,,,,,,,,,,,,,,,,,,,,,,,,,,,,,,,,,,,,,,,,,,,,,",
        ",,,,,,,,,,,,,,,,,,,,,,,,,,,,,,,,,,,,,,,,,,,,,,,,,,,,,,,,,,,,,,,,,,,,,,,,,,,,,,,,,,=|PLPLPLPLPLPLPLPLPLPLPLDDPDPDPDPDPDPDPDPDPD=|,,,,,,,,,,,,,,,,,,,,,,,,,,,,,,,,,,,,,,,,,,,,,,,,,,,,,,,,,,,,,,,,,,,,,,,,",
        ",,,,,,,,,,,,,,,,,,,,,,,,,,,,,,,,,,,,,,,,,,,,,,,,,,,,,,,,,,,,,,,,,,,,,,=<===========TDDDDDDDDDDDD=D=========TDDDDDDDDDD=========L,,,,,,,,,,,,,,,,,,,,,,,,,,,,,,,,,,,,,,,,,,,,,,,,,,,,,,,,,,,,,,,,,,,,,,,,",
        ",,,,,,,,,,,,,,,,,,,,,,,,,,,,,,,,,,,,,,,,,,,,,,,,,,,,,,,,,,,,,,,,,,,,,,=|TMTMTMTMTMTMTMTMTMTMTMTMDDTRTRTRTRTRTRTRTRTRTRTRTRTRTRDDWDWD,,,,,,,,,,,,,,,,,,,,,,,,,,,,,,,,,,,,,,,,,,,,,,,,,,,,,,,,,,,,,,,,,,,,",
        ",,,,,,,,,,,,,,,,,,,,,,,,,,,,,,,,,,,,,,,,,,,,,,,,,,,,,,,,,,,,,,,,,,,,,,DDTMTMTMTMCRCRCRCRCRCRTMTMDDTRTRTRTRTRTRTRTRTRTRTRTRTRTRDDWDWD,,,,,,,,,,,,,,,,,,,,,,,,,,,,,,,,,,,,,,,,,,,,,,,,,,,,,,,,,,,,,,,,,,,,",
        ",,,,,,,,,,,,,,,,,,,,,,,,,,,,,,,,,,,,,,,,,,,,,,,,,,,,,,,,,,,,,,,,,,,,,,DDTMTMTMTMCRCRCRCRCRCRTMTMDDTRTRTRTRTRTRTRTRTRTRTRTRTRTRDDWDWD,,,,,,,,,,,,,,,,,,,,,,,,,,,,,,,,,,,,,,,,,,,,,,,,,,,,,,,,,,,,,,,,,,,,",
        ",,,,,,,,,,,,,,,,,,,,,,,,,,,,,,,,,,,,,,,,,,,,,,,,,,,,,,,,,,,,,,,,,,,,,,DDTMTMTMTMCRCRCRCRCRCRTMTMDDTRTRTRTRTRTRTRTRTRTRTRTRTRTR=|,,,,,,,,,,,,,,,,,,,,,,,,,,,,,,,,,,,,,,,,,,,,,,,,,,,,,,,,,,,,,,,,,,,,,,,,",
        ",,,,,,,,,,,,,,,,,,,,,,,,,,,,,,,,,,,,,,,,,,,,,,,,,,,,,,,,,,,,,,,,,,,,,,DDTMTMTMTMCRCRCRCRCRCRTMTMTYTYTYTYTYTYTYTYTYTYTYTYTYTYTYTYTYTYTYTYTY,,,,,,,,,,,,,,,,,,,,,,,,,,,,,,,,,,,,,,,,,,,,,,,,,,,,,,,,,,,,,,",
        ",,,,,,,,,,,,,,,,,,,,,,,,,,,,,,,,,,,,,,,,,,,,,,,,,,,,,,,,,,,,,,,,,,,,,,=|TMTMTMTMCRCRCRCRCRCRTMTMTYTYTYTYTYTYTYTYTYTYTYTYTYTYTYTYTYTYTYTYTY,,,,,,,,,,,,,,,,,,,,,,,,,,,,,,,,,,,,,,,,,,,,,,,,,,,,,,,,,,,,,,",
        ",,,,,,,,,,,,,,,,,,,,,,,,,,,,,,,,,,,,,,,,,,,,,,,,,,,,,,,,,,,,,,,,,,,,,,=|TMTMTMTMTMTMTMTMTMTMTMTMTYTYTYTYTYTYTYTYTYTYTYTYTYTYTYTYTYTYTYTYTY,,,,,,,,,,,,,,,,,,,,,,,,,,,,,,,,,,,,,,,,,,,,,,,,,,,,,,,,,,,,,,",
        ",,,,,,,,,,,,,,,,,,,,,,,,,,,,,,,,,,,,,,,,,,,,,,,,,,,,,,,,,,,,,,,,,,,,,,=(======%%%%%%%%%%%%%%====TYTYTYTYTYTYTYTYTYTYTYTYTYTYTYTYTYTYTYTYTY,,,,,,,,,,,,,,,,,,,,,,,,,,,,,,,,,,,,,,,,,,,,,,,,,,,,,,,,,,,,,,",
        ",,,,,,,,,,,,,,,,,,,,,,,,,,,,,,,,,,,,,,,,,,,,,,,,,,,,,,,,,,,,,,,,,,,,,,,,,,,,,,,,,,,,,,,,,,,,,,,,TYTYTYTYTYTYTYTYTYTYTYTYTYTYTYTYTYTYTYTYTY,,,,,,,,,,,,,,,,,,,,,,,,,,,,,,,,,,,,,,,,,,,,,,,,,,,,,,,,,,,,,,",
        ",,,,,,,,,,,,,,,,,,,,,,,,,,,,,,,,,,,,,,,,,,,,,,,,,,,,,,,,,,,,,,,,,,,,,,,,,,,,,,,,,,,,,,,,,,,,,,,,TYTYTYTYTYTYTYTYTYTYTYTYTYTYTYTYTYTYTYTYTY,,,,,,,,,,,,,,,,,,,,,,,,,,,,,,,,,,,,,,,,,,,,,,,,,,,,,,,,,,,,,,",
        ",,,,,,,,,,,,,,,,,,,,,,,,,,,,,,,,,,,,,,,,,,,,,,,,,,,,,,,,,,,,,,,,,,,,,,,,,,,,,,,,,,,,,,,,,,,,,,,,TYTYTYTYTYTYTYTYTYTYTYTYTYTYTYTYTYTYTYTYTY,,,,,,,,,,,,,,,,,,,,,,,,,,,,,,,,,,,,,,,,,,,,,,,,,,,,,,,,,,,,,,",
        ",,,,,,,,,,,,,,,,,,,,,,,,,,,,,,,,,,,,,,,,,,,,,,,,,,,,,,,,,,,,,,,,,,,,,,,,,,,,,,,,,,,,,,,,,,,,,,,,TYTYTYTYTYTYTYTYTYTYTYTYTYTYTYTYTYTYTYTYTY,,,,,,,,,,,,,,,,,,,,,,,,,,,,,,,,,,,,,,,,,,,,,,,,,,,,,,,,,,,,,,",
        ",,,,,,,,,,,,,,,,,,,,,,,,,,,,,,,,,,,,,,,,,,,,,,,,,,,,,,,,,,,,,,,,,,,,,,,,,,,,,,,,,,,,,,,,,,,,,,,,,,,,,,,,,,,,,,,,,,,,,,,,,,,,,,,,,,,,,,,,,,,,,,,,,,,,,,,,,,,,,,,,,,,,,,,,,,,,,,,,,,,,,,,,,,,,,,,,,,,,,,,,",
        ",,,,,,,,,,,,,,,,,,,,,,,,,,,,,,,,,,,,,,,,,,,,,,,,,,,,,,,,,,,,,,,,,,,,,,,,,,,,,,,,,,,,,,,,,,,,,,,,,,,,,,,,,,,,,,,,,,,,,,,,,,,,,,,,,,,,,,,,,,,,,,,,,,,,,,,,,,,,,,,,,,,,,,,,,,,,,,,,,,,,,,,,,,,,,,,,,,,,,,,,",
        ",,,,,,,,,,,,,,,,,,,,,,,,,,,,,,,,,,,,,,,,,,,,,,,,,,,,,,,,,,,,,,,,,,,,,,,,,,,,,,,,,,,,,,,,,,,,,,,,,,,,,,,,,,,,,,,,,,,,,,,,,,,,,,,,,,,,,,,,,,,,,,,,,,,,,,,,,,,,,,,,,,,,,,,,,,,,,,,,,,,,,,,,,,,,,,,,,,,,,,,,",
        ",,,,,,,,,,,,,,,,,,,,,,,,,,,,,,,,,,,,,,,,,,,,,,,,,,,,,,,,,,,,,,,,,,,,,,,,,,,,,,,,,,,,,,,,,,,,,,,,,,,,,,,,,,,,,,,,,,,,,,,,,,,,,,,,,,,,,,,,,,,,,,,,,,,,,,,,,,,,,,,,,,,,,,,,,,,,,,,,,,,,,,,,,,,,,,,,,,,,,,,,",
        ",,,,,,,,,,,,,,,,,,,,,,,,,,,,,,,,,,,,,,,,,,,,,,,,,,,,,,,,,,,,,,,,,,,,,,,,,,,,,,,,,,,,,,,,,,,,,,,,,,,,,,,,,,,,,,,,,,,,,,,,,,,,,,,,,,,,,,,,,,,,,,,,,,,,,,,,,,,,,,,,,,,,,,,,,,,,,,,,,,,,,,,,,,,,,,,,,,,,,,,,",
        ",,,,,,,,,,,,,,,,,,,,,,,,,,,,,,,,,,,,,,,,,,,,,,,,,,,,,,,,,,,,,,,,,,,,,,,,,,,,,,,,,,,,,,,,,,,,,,,,,,,,,,,,,,,,,,,,,,,,,,,,,,,,,,,,,,,,,,,,,,,,,,,,,,,,,,,,,,,,,,,,,,,,,,,,,,,,,,,,,,,,,,,,,,,,,,,,,,,,,,,,",
        ",,,,,,,,,,,,,,,,,,,,,,,,,,,,,,,,,,,,,,,,,,,,,,,,,,,,,,,,,,,,,,,,,,,,,,,,,,,,,,,,,,,,,,,,,,,,,,,,,,,,,,,,,,,,,,,,,,,,,,,,,,,,,,,,,,,,,,,,,,,,,,,,,,,,,,,,,,,,,,,,,,,,,,,,,,,,,,,,,,,,,,,,,,,,,,,,,,,,,,,,",
        ",,,,,,,,,,,,,,,,,,,,,,,,,,,,,,,,,,,,,,,,,,,,,,,,,,,,,,,,,,,,,,,,,,,,,,,,,,,,,,,,,,,,,,,,,,,,,,,,,,,,,,,,,,,,,,,,,,,,,,,,,,,,,,,,,,,,,,,,,,,,,,,,,,,,,,,,,,,,,,,,,,,,,,,,,,,,,,,,,,,,,,,,,,,,,,,,,,,,,,,,",
        ",,,,,,,,,,,,,,,,,,,,,,,,,,,,,,,,,,,,,,,,,,,,,,,,,,,,,,,,,,,,,,,,,,,,,,,,,,,,,,,,,,,,,,,,,,,,,,,,,,,,,,,,,,,,,,,,,,,,,,,,,,,,,,,,,,,,,,,,,,,,,,,,,,,,,,,,,,,,,,,,,,,,,,,,,,,,,,,,,,,,,,,,,,,,,,,,,,,,,,,,"
      ]
    },
    {
      "name": "Mid",
      "data": [
        "............................................................................................................~~~~~~~~~~~~~~~~~~~~........................................................................",
        "..................................................................................................~~~~~~~~~~~~~~~~~~~~~~~~~~~~~~~~~~~~~~~~~~~~..........................................................",
        "..............................................................................................~~~~~~~~~~~~~~~~~~~~~~~D~D~D~D~D~~~~~~~~~~~~~~~~~~~~~~....................................................",
        "....................................BBBBBBBBBBBBBB........................................~~~~~~~~~~~~~~~~~~~D~D~D~D~D~D~D~D~D~D~D~D~~~~~~~~~~~~~~~~~~~~................................................",
        "..........................................................................................~~~~~~~~~~~~~~~~~~~D~D~D~D~D~D~D~D~D~D~D~D~~~~~~~~~~~~~~~~~~~~................................................",
        "............................................................BBBBBBBBBB....................~~~~~~~~~~~~~~~~~~~~~~~~~~~D~D~D~D~D~~~~~~~~~~~~~~~~~~~~~~~~~~................................................",
        "..................................................................................................~~~~~~~~~~~~~~~~~~~~~~~~~~~~~~~~~~~~~~~~~~~~..........................................................",
        "..............BBBBBBBBBBBB..............................................................................~~~~~~~~~~~~~~~~~~~~............................................................................",
        "..............................................................................................................................................................................WL........................",
        "........................................................................................................................................................................................................",
        "..................................................................................=<====%%%%%%%%%%%%%%=====>............................................................................................",
        "..............................BBBBBBBBBbBBBBBbBBBBBB..............................=|..................WDWD=|............................................................................................",
        "..................................................................................%%..................WDWD=R====%%%%%%%%=======>........................................................................",
        "..................................................................................%%..................WDWD=|..................=|..............................................BBBBBBBBBBBBBBBBBB........",
        "..................................................................................=|......................DD..................%%........................................................................",
        "..................................................................................%%......................DD..................%%........................................................................",
        "..................................................................................%%......................DD..................%%........................................................................",
        "..................................................................................=|......................DD..................=|........................................................................",
        "......................................................................=<===========TDDDDDDDDDDDD=D=========TDDDDDDDDDD=========L........................................................................",
        "......................................................................=|WLWLWLWLWL..............DD............................DD........................................................................",
        "......................................................................DD........................DD............................DD........................................BBBBBBBBBBBBBBBB................",
        "BBBBBBBBBB............................................................DD........................DD............................DD........................................................................",
        "......................................................................DD........................DD............................=|........................................................................",
        "......................................................................DD........................=R======DDDDDDDDDDDDDDDD=======T=========>..............................................................",
        "......................................................................=|........................=|..........................WDWDWDWDWD..=|..............................................................",
        "..................................WD..................................=|........................=|WDWD..................................DD..............................................................",
        "BBBBBBBBBBBBBB........................................................=(======%%%%%%%%%%%%%%=====LWDWD..................................DD..............................................................",
        "................................................................................................=|WDWD..................................DD..........................................BBBBBBBBBBBB........",
        "................................................................................................=|WDWD..................................DD..............................................................",
        "................................................................................................=|......................................DD..............................................................",
        "................................................................................................=(==========DDDDDDDDDDDDDDDDDDDD=========)..............................................................",
        "..BBBBBBBBBBBB..........................................................................................................................................................................................",
        "........................................................................................................................................................................................................",
        "......................................................WD................................................................................................................................................",
        "........................................................................................................................................................................................................",
        "........................................................................................................................................................................................................",
        "..............................WD..............................................................................................WD........................................................................",
        "............................................................................WD..........................................................................................................................",
        "........................................................................................................................................................................................................",
        "..........BBBBBBBBBBBBBBBB.............................................................................................................................................................................."
      ]
    },
    {
      "name": "Top",
      "data": [
        "........................................................................................................................................................................................................",
        "..........................................BBBB..........................................................................................................................BBBBBBBBBBBBBBBB................",
        "......................................BBBBBBBBBB........................................................................................................................BBBBBBBBBBBBBBBB................",
        "............................................................................................................................................................................BBBBBBBBBBBB................",
        "..............................................................BBBBBB........................................................................................................BBWLBB......................",
        "................BB............................................................................................................................................................WL........................",
        "................BBBBBB........................................................................................................................................................WL........................",
        "..............................................................................................................................................................................WL........................",
        "........................................................................................................................................................................................................",
        "....................................BBBBBb..............................................................................................................................................................",
        "................................BBBBBbBBBBBBBB..........................................................................................................................................................",
        "....................................................................................................................................................................................BB..................",
        "..................................................................................................................................................................................BBBBBB..BBBBBB........",
        "........................................................................................................................................................................................................",
        "........................................................................................................................................................................................................",
        "........................................................................................................................................................................................................",
        "........................................................................................................................................................................................................",
        "..................................BBBBBB......................................................................................................................................BBBBBB....................",
        "......BB........................BBBBBBBBBB..................................................................................................................................BBBBBBBBBB..................",
        "..BBBBBB......................BBBBBBBaBBBB..................................................................................................................................BBBBBBBBBBBB................",
        "..BBBBBB......................BaBBBBBBBBBBBB............................................................................................................................................................",
        "................................BBBBBBBBBaBB............................................................................................................................................................",
        "..................................WD..BBBB..............................................................................................................................................................",
        "..................................WD....................................................................................................................................................................",
        "BBBBBB............................WD....................................................................................................................................................................",
        "BBBBBBBBBB..............................................................................................................................................................................................",
        "......................................................BB..............................................................................................................................BBBB..BB..........",
        "....................................................BBBBBB..............................................................................................................................................",
        "......................................................WD................................................................................................................................................",
        "....BBBBBB........................................BBBBBBBBBB............................................................BBBBBBBB........................................................................",
        "....BBBBBBBB..................BBBB..................BBWDBB..................BB..........................................BBBBBBBBBBBBBB..................................................................",
        "............................BBBBBBBBBB..........BBBBBBBBBBBBBB............BBWDBB........................................BBBBBBBBBBBBBB..................................................................",
        "..........................BBBBBBBBBaBB................WD................BBBBBBBBBB............................................WDBB......................................................................",
        "..........................BBBBBaBBBBBB......................................WD..............................................BBWDBB......................................................................",
        "..............................WD......................................BBBBBBBBBBBBBB..........................................WD........................................................................",
        "..............................WD............................................WD................................................WD........................................................................",
        "....................................................................BBBBBBBBBBBBBBBBBB..................................................................................................................",
        "........................................................................................................................................................................................................",
        "..............BBBBBBBBBB................................................................................................................................................................................",
        "........................................................................................................................................................................................................"
      ]
    }
  ]
}
