;;;;;;;;;;;;;;;;;;;;;;;;;;;;;;;;;;;@@@@@@@@@@@@@@@@@@@@@;;;;;;;;;;;;;;;;;;;;;;;;;;;;;;;;;;;;;;;;;@@@@@@@@@@@@@@@@@@@@@@@@@@@@@@@@@@@@@@@@@
;;;;;;;;;;;;;@;;;;;;;;;;;;;;;;;;;;;;;;;;;;@@@@@@@;;;;;;;;;;;;;;;;;;;;;;;;;;;;;;;;;;;;;;;;;;;;;;;;;;;;;;;;;;;@@@@@@@@@@@@@@@@@@@@@@@@@@@@@@
;;;;;;;;;;;;;;;;;;;;;;;;;;@;;;;;;;;;;;;;;;;;;@@;;;;;;;;;;;;;;;;;;;;;;;;;;;;@;;;;;;;;;;;;;;;;;;;;;;;;;;;;;;;;;;;;;;;;;;;;;@;;;;@@@@@@@@@@@@
;;;;;;;;;;;;;;;;;;;@;;@;;;;;;;;;;;;;;;;;;;;;;;;;;;;;;;;;;;;;;;;;;;;;;;;;;;;;;;;;;;;;;;;;;;;;;;;;;;;;;;;;;;;;;;;;;;;;;;;;;;;;;;;;;;;@@@@@@@
;;;;;;;;;;;;;;;;;@;;;;@;;@;;;@;;;;;;;;;;;;;;;;;;;;;;;;;;;;;;;;;;;;;;;;;;;;;;;;;;;;;;;;;;;;;;;;;;;;;;;;;;;;;;;;;;;;;;;;;;;;;;;;;;;;;;;;;@@@
;;;;;;;;;;;;;;;;;;@;;;;;@;;;;;;;;;;;;;;;;;;;;;;;;;;;;;;;;;;;;;;;;;;;;;;;;;;;;;;;;;;;;;;;;;;;;;;;;;;;;;;;@;;;;;;;;;;;;;;;;;;;;;;;;;;;;;;;;@
;;;;;;;;;;;;;;;;;;@;@;;;;;@;;;;;;;;;;;;;;;;;;;;;;;;;;;;;;;;;;;;;;;;;;;;;;;;;;;;;;;;;;;;;;;;;;;;;;;;;;;;;;;;;;;;;;;;;;;;;;;;;;;;;;;;;;;;;;@
;;;;;;;;;;;;;@;@;;;;@;;@;;;;;;;;;;;;;;@;;;;;;;;;;;;;;;;;;;;;;;;;;;;;;;;;;;;;;;;;;;;;;;;;;;;;;;;;;;;;;;;;;;;;;;;;;;;;;;;;;;;@;;;;;;;;;;;;;;
;;;;;;;;;;;@;;;@;;;@;;;;;;;;;;;;;;;;;;;;;;;;;;;;;;;;;;;;;;;;;;;;;;;;;;;;;;;;;;;;;;;;;;;;;;;;;;;;;;;;;;;;;;;;;;;;;;;;;;;;;;;;;;;;;;;;;;;;;;
;;;;;;;;;@;;;;@;@;;@;;;;;;;;;;;;;;;;;;;;;;;;;;;;;;;;;;;;;;;;;;;;;;;;;;;;;;;;;;;;;;;;;;;;;;;;;;;;;;;;;;;;;;;;;;;;;;;;;;;;;;;;;;;;;;;;;;;;;;
;;;;;;;;;;;;@;;;@;;;;;;;;;;;;;;;;;;;;;;;;<==========DDDD=============%%%%====DDDDD=========>;;;;;;;;;;;;;;;;;;;;;;;;;;;;;;;;;;;;;;;;;;;;;;   
;;;;;;;;;;;;;@;;;;;;;;;;;;;;;@;;;;;;;;;;;|########################|########################|;;;;;;;;;;;;;;;;;;;;;;;;;;;;;;;;;;;;;;;;;;;;;;   
;;;;;;;;;@;;@@@;;;;;;;;;;;;;;;;;;;;;;;;;;%########################|########################%;;;;;;;;;;;;;;;;;;;;;;;;;;;;;;;;;;;;;;;;;;;;;;   
;;;;;;;;;;;;@@@;;;;@;;;;;;;;;;;;;;;;;;;;;%########################|########################%;;;;;;;;;;;;;;;;;;;;;;;;;;;;;;;;;;;;;;;;;;;;;;   
;;;;;;;;;@;@@@;;;;;;;;;;;;;;;;;;;;;;;;;;;%########################|########################%;;;;;;;;;;;;;;;;;;;;;;;;;;;;;;;;;;;;;;;;;;;;;;   
;;;;;;@;;;;;;;;@;;;;;;;;;;;;;;;;;;;;;;;;;|########################|########################|;;;;;;;;;;;;;;;;;;;;;;;;;;;;;;;;;;;;;;;;;;;;;;   
;@;;;;;;@;;;;;;;;;;;;;;;;;;;;;;;;;;;;;;;;D########################D########################D;;;;;;;;;;;;;;;;;;;;;;;;;;;;;;;;;;;;;;;;;;;;;;   
@@@@@;;@;;;;@;;;;;;;;;;;;;;;;;;;;;;;;;;;;D########################D########################D;;;;;;;;;;;;;;;;;;;;;;;;;;;;;;;;;;;;;;;;;;;;;;   
@@@;;;;;;;;;;;;;;;@;;;;;;;;;;;;;;;;;;;;;;D########################|########################D;;;;;;;;;;;;;;;;;;;;;;;;;;;;;;;;;;;;;;;;;;;;;;   
@@@@@@@@;;;;;;;;;;;;;;;;;;;;;;;;;;;;;;;;;(============DDDDDD=>DDDD(====###########=<=======);;;;;;;;;;;@;;;;;;;;;;;;;;;;;;;;;;;;;;;;;;;;;;   
@@@@@@;;;;@;;;;@;;;;;;;;;;;;;;;;;;;;;;;;;;;;;;;;;;;;;;;;;;;;;|#####################|;;;;;;;;;;;;;;;;;;;;;;;;;;;;;;;;;;;;;;;;;;;;;;;;;;;;;;
;;@;;;;@;;;;;;;;;;;;;;;;;;;;;;;;;;;;;;;;;;;;;;;;;;;;;;;;;;;;;|#####################|;;;;;;;;;;;;;;;;;;;;;;;;;;;;;;;;;;;;;;;;;;;;@;;;;;;;;;
;@;;;;;;;;;;;;;;@;;;;;;;;;;;;;;;;;;;;;;;;;;;;;;;;;;;;;;;;;;;;|#####################%;;;;;;;;;;;;;;;;;;;;;;;;;;;;;;;;;;;;;;;;;;;;;;;;;;;;;;
;;@@@@;;;;;;;;;;;;;;;;;;;;;;;;;;;;;;;;;;;;;;;;;;;;;;;;;;;;;;;|#####################%;;;;;;;;;;;;;;;;;;;;;;;;;;;;;;;;;;;;;;;;;;;;;;;;;;;;;;
;;;;;@@@;;@;;;;;;;;;;;;;;;;;;;;;;;;;;;;;;;;;;;;;;;;;;;;;;;;;;|#####################%;;;;;;;;;;;;;;;;;;;;;;;;;;;;;;;;;;;;;;;;;;;;;;;;;;;;;;
;;@;;@;;;;;;;;;;;;;;;;;;;;;;;;;;;;;;;;;;;;;;;;;;;;;;;;;;;;;;;|#####################|;;;;;;;;;;;;;;;;;;;;;;;;;;;;;;;;;;;;;;;;;;;;;;;;;;;;;;
;;;;@@@@;;;;;;;;;;;;;;;;;;;;;;;;;;;;;;;;;;;;;;;;;;;;;;;;;;;;;(==%%%%======DDDDD====);;;;;;;;;;;;;;;;;;;;;;;;;;;;;;;;;;;;;;;;;;;@;;;;;;;;;;
@@@@@;;;;@;;;;;;;;;;;@;;;;;;;;;;;;;;;;;;;;;;;;;;;;;;;;;;;;;;;;;;;;;;;;;;;;;;;;;;;;;;;;;;;;;;;;;;;;;;;;;;;;;;;;;;;;@;;;;;;;;;;;;;;;;;;;;;;;
;;@;;;;;;;;;;;;;;@;;;;;;;;;;;;;;;;;;;;;;;;;;;;;;;;;;;;;;;;;;;;;;;;;;;;;;;;;;;;;;;;;;;;;;;;;;;;;;;;;;;;;;;;;;;;;;;;;;;;;;;;;;;;;;;;;;;;;;;;
;;;;;;;;;;;;;;;;;;;;;;;;;;;;;;;;;;;;;;;;;;;;;;;;;;;;;;;;;;;;;;;;;;;;;;;;;;;;;;;;;;;;;;;;;;;;;;;;;;;;;;;;;;;;;;;;;;;;;;;;;;;;;;;;;;;;;;;;;;
;;;;;;;@;;;;;;@;;;;;;;;;;@;;;;;;;;;;;;;;;;;;;;;;;;;;;;;;;;;;;;;;;;;;;;;;;;;;;;;;;;;;;;;;;;;;;;;;;;;;;;;;;;;;;;;;@;;;;;;;;;;;;;;;;;;;;;;;;;
;;;;;;@;;;@@@@@;;;@;;;;@;;;;;;;;;;;;@;;;;;;;;;;;;;;;;;;;;;;;;;;;;;;;;;;;;;;;;;;;;;;;;;;;;;;;;;;@;;;;;;;;;;;;;;;;;;;;;;;;;;;;;;;;;;;;;;;;;;
;;@;;;;;@@@@@@;;;;;;;;;;;;@;;;;;;;;;;;;;;;;;;;;;;;;;;;;;;;;;;;;;;;;;;;;;;;;;;;;;;;;;;;;;;;;;;;;;;;;;;;;;;;;;;;;;;;;;;;;;;;@;;;;;;;;;;;;;;;
;;;;;;;;;@@@;;@;;;@;;;;;;;;;;@;;;;;;;;;;@;;;;;;;;;;;;;;;;;;;;;@;;;;;;;;;;;;;;;;;;;;;;;;;;@;;;;;;;;;;;;;;;;;;;;;;;;;;;;;;;;;;;;;;;;;;;;;;;;
;;;;@;;;;;;;;;;;;;;;@;;;@;;;;;;;;;@;;;;;;;;@;;;;;;;;;;;;;;;;;;;;;;;;;;;;;;;;;;;;;;;;;;;;;;;;;;;;;;;;;;;;;@;;;;;;;;;;;;;;;;;;;;;;;;;;;;;;;;
;;;;;;;;;@;;;;;@;;;@;;;;;;;@;;;;;;;;;@;;;;;;;;;;;@;;;;;;;;;;;;;;;;@;;;;;;;;;@;;;@;;;;;;@;;;;@;;;;@;;@;;;;;;;;;;;;;;;;;;;;;;;;;;;;;;@;;;;;;
;;;;;;@;;;;;;;;;@;;;;;;;;@;;;;;;;;@;;;;;;;;@;;;;;;;@;;;;;;@@@@@@@@@@;;;;@;;;;;;;;;@@@@@@@@@@@@@@@@@@;@;;;@;;;;@;;;;;;;;;;;;;;;;;;;;;;;;;;;